111111111111111111111111111111
100000000000000000000000000001
10P000000000000000000000000001
1000000000000N0000000000000001
100000000000000000000000000001
10000000000000000000000C000001
100000000000000000000000000001
1000000C0000000000000000000001
100000000000000000000000000001
100000000000000000000000000001
100000000000000000000000000001
100000000000000000000000000001
1000000000000000000N0000000001
100000000000000000000000000001
10000000N000000000000000000001
100000000000000000000000000001
100000000000000C00000000000001
100000000000000000N00000000001
1000000000000000000000000000E1
111111111111111111111111111111
