1111111111111111111111111111111111
1000000000000000000000000000000001
10P00000000000000000000000C0000001
1000000000000N00000000000000000001
1000000000000000000000000000000001
10000000000000000000000C0000000001
1000000000000000000000000000000001
1000000C00000000000000000000000001
1000000000000000000000000000000001
1000000000000000000000000000000001
1000000000000000000000000000000001
1000000000000000000000000000000001
1000000000000000000N0000000N000001
1000000000000000000000000000000001
10000000N0000000000000000000000001
10000000000000000000000000000C0001
1000000000000000000000000000000001
100C00000000000000N000000000000E01
1000000000000000000000000000000001
1111111111111111111111111111111111
